Отчет об оценке № O-0912/2022 рыночной стоимости исключительного права Ha англоязычную версию программного
обеспечения «tNAVIGATOR», принадлежащего ООО «РфД».

Дата оценки: 09.12.2022г.

РУ (Present Value) — текущая (приведенная) стоимость.

ТУ (Terminal Value) — рыночная стоимость в постпрогнозном периоде (реверсия).
ВУ (Book Value) — балансовая (книжная) стоимость.

МУ (Market Value) — рыночная стоимость.

NPV (Net Present Value) — чистая приведенная стоимость.

EVA (Economic Value Added) — добавленная экономическая стоимость

ROA (Return on Assets) — доходность активов.

ROE (Return on Equity) — доходность собственного капитала.

IRR (Internal Rate of Return) — внутренняя норма доходности.

g (Growth Rate) — темпы прироста.

CAGR (Compound Annual Growth Rate) — среднегодовой рост (темп прироста) в сложных
процентах.

CF (Cash Flow) — денежный поток.

DCF (Discounted Cash Flow) — дисконтированный денежный поток.

FCFF (Free Cash Flow to Firm) — денежный поток для инвестированного капитала.
FCFE (Free Cash Flow to Equity) — денежный поток для собственного капитала.
EPS (Earnings per (for) Share) — прибыль на акцию.

$ (Sales) — выручка.

EBIT (Earnings Before Interest and Taxes) — прибыль до выплаты процентов по обязательствам и до
выплаты налогов.

EBITDA (Earnings Before Interest, Taxes, Depreciation and Amortization) — прибыль до выплаты
процентов по обязательствам, до выплаты налогов, амортизации и износа.

OIBDA (Operating Income Before Depreciation and Amortization) — операционный доход до вычета
износа основных средств и амортизации нематериальных активов.

OI (Operating Income) — операционный доход.

SG&A (Selling, General and Administrative Expenses) — общие, сбытовые и административные
расходы.

Е (Earnings) — чистая прибыль.
WC (Working Capital) — рабочий капитал.
D (Debt) - долг.

14
